passing
0,0,0,0,0,0,0,0,0,0
0,0,0,0,2,0,0,0,0,0
0,0,0,4,0,0,0,0,0,0
0,0,0,2,1,0,0,0,0,0
0,0,1,4,2,4,4,4,4,0
0,0,0,0,0,0,0,0,0,0
0,0,0,0,0,0,0,0,0,0
0,0,0,0,0,0,0,0,0,0
0,0,0,0,0,0,0,0,0,0
0,0,0,0,0,0,0,0,0,0
beam:4
diamondBeam:0
cubeBeam:1
cubeBeam:0
vortexBeam:8
none:0
modulate:true
shuffle:false
tutorialText:30 levels left