crossing
0,0,0,0,0,0,0,0,0,0
0,2,0,0,0,0,3,0,0,0
0,2,0,0,0,3,0,0,0,0
6,6,3,6,6,2,3,3,3,3
0,0,2,0,3,0,0,0,0,0
0,0,0,2,3,0,0,0,0,0
0,0,0,6,0,0,0,0,0,0
0,0,0,3,2,0,0,0,0,0
0,0,0,0,0,0,0,0,0,0
0,0,0,0,0,0,0,0,0,0
beam:6
cubeBeam:1
cubeBeam:2
vortexBeam:8
diamondBeam:6
none:7
