hard1
0,0,0,0,4,0,0,0,0,0
0,0,0,0,1,2,0,0,0,0
0,0,2,4,4,4,1,4,0,0
0,0,4,0,0,0,0,0,2,0
0,0,1,0,2,0,0,4,0,0
0,0,0,4,0,4,4,1,4,0
0,2,4,0,0,1,0,0,2,0
0,4,0,1,0,0,4,0,0,4
0,2,4,0,0,0,2,4,1,0
0,0,0,0,0,0,0,0,0,0
pyramid:0
none:0
none:0
none:0
none:0
none:0
