L4
0,0,0,0,0,0,0,0,0,0
0,0,0,0,0,0,0,0,0,0
0,0,0,0,0,0,0,0,0,0
0,0,0,0,0,0,0,0,0,0
0,0,0,2,5,4,1,0,0,0
0,0,0,1,0,4,0,1,0,0
0,0,0,1,4,5,2,0,0,0
0,0,0,0,0,0,0,0,0,0
0,0,0,0,0,0,0,0,0,0
0,0,0,0,0,0,0,0,0,0
sphere:6
diamond:0
cubeNova:6
vortexNova:8
cubeBeam:1
none:7
