L5
0,0,0,0,0,0,0,0,0,0
0,0,0,2,2,1,2,2,0,0
0,0,5,6,4,4,6,2,0,0
0,0,0,2,3,1,3,2,0,0
0,6,6,1,3,3,1,0,0,0
0,6,4,1,5,6,5,0,0,0
0,6,6,0,2,2,0,0,0,0
0,0,0,0,0,0,0,0,0,0
0,0,0,0,0,0,0,0,0,0
0,0,0,0,0,0,0,0,0,0
sphere:6
cubeNova:6
vortex:6
cube:6
vortexBeam:8
vortexBeam:8
