hard2
0,0,0,0,0,0,0,0,0,0
0,0,0,0,2,2,0,0,0,0
0,0,4,5,0,5,4,0,0,0
0,0,0,0,5,5,0,0,0,0
0,0,2,2,1,2,2,0,0,0
0,0,0,0,3,3,0,0,0,0
0,0,0,3,0,3,4,4,0,0
0,0,4,4,0,0,4,0,0,0
0,0,0,4,0,0,4,0,0,0
0,0,0,0,0,0,0,0,0,0
nova:3
diamondNova:0
vortexBeam:8
cubeBeam:6
vortexBeam:8
none:7
