hard3
0,0,0,0,4,0,4,0,0,0
0,0,0,4,0,4,4,0,4,0
0,0,0,4,4,3,4,4,0,0
0,0,0,0,0,5,6,0,0,0
0,0,0,0,5,0,6,0,0,0
0,0,0,4,5,0,0,6,4,0
0,0,4,0,4,4,4,0,4,0
0,0,0,0,4,0,0,4,0,0
0,0,0,0,0,0,0,0,0,0
0,0,0,0,0,0,0,0,0,0
nova:2
diamondBeam:0
diamondBeam:1
cubeNova:6
vortexNova:6
none:7
