L6
0,0,0,0,0,0,0,0,0,0
0,0,0,0,0,0,0,0,0,0
0,0,0,0,0,0,0,0,0,0
0,0,0,0,5,3,3,3,0,0
0,0,0,1,2,0,0,3,0,0
0,1,1,3,3,1,6,2,2,0
0,0,1,0,0,2,0,3,0,0
0,0,5,3,3,3,6,3,0,0
0,0,0,0,0,0,0,0,0,0
0,0,0,0,0,0,0,0,0,0
beam:8
cubeBeam:6
cubeBeam:6
vortexBeam:8
cubeNova:6
none:7
