L10
0,0,0,0,0,0,0,0,0,0
0,0,0,0,0,0,0,0,0,0
0,0,0,1,2,3,5,0,0,0
0,0,0,6,4,0,1,2,0,0
0,0,2,1,3,6,5,6,0,0
0,0,2,5,3,0,2,4,6,0
0,0,6,6,0,2,0,3,0,0
0,0,0,0,0,6,6,3,0,0
0,0,0,0,0,0,0,0,0,0
0,0,0,0,0,0,0,0,0,0
pyramid:6
beam:8
beam:8
vortexBeam:8
none:7
none:7
modulate:true
shuffle:false
tutorialText:20 levels left