L11
0,0,0,0,0,0,0,0,0,0
0,0,3,0,0,0,0,3,0,0
0,2,6,6,2,6,6,2,0,0
0,0,3,0,3,3,0,3,0,0
0,0,1,5,1,5,1,0,0,0
0,0,0,1,3,3,1,0,0,0
0,0,0,1,0,1,0,0,0,0
0,0,0,2,5,5,2,0,0,0
0,0,2,0,5,0,2,0,0,0
0,0,0,0,0,0,0,0,0,0
sphere:6
diamondNova:0
cubeNova:6
vortex:6
cubeNova:6
cubeBeam:6
