L12
0,0,0,0,0,0,0,0,0,0
0,0,0,0,0,0,0,0,0,0
0,0,0,0,0,0,0,0,0,0
0,0,0,1,2,2,3,0,0,0
0,0,1,0,0,0,3,0,0,0
0,0,6,0,0,0,0,1,0,0
0,0,1,0,0,0,6,0,0,0
0,0,0,4,3,5,2,0,0,0
0,0,0,0,0,0,0,0,0,0
0,0,0,0,0,0,0,0,0,0
pyramid:3
vortex:8
none:7
none:7
none:7
none:7
