L13
0,0,0,0,0,0,0,0,0,0
0,0,0,0,0,0,0,0,0,0
0,0,0,0,0,0,0,0,0,0
0,0,0,3,2,3,0,0,0,0
0,1,5,4,4,5,1,0,0,0
0,6,5,2,2,2,5,6,0,0
0,1,2,0,0,2,1,0,0,0
0,0,0,0,0,0,0,0,0,0
0,0,0,0,0,0,0,0,0,0
0,0,0,0,0,0,0,0,0,0
sphere:6
cube:6
vortexBeam:8
cubeNova:6
diamond:6
none:7