L14
0,0,0,0,0,0,0,0,0,0
0,0,0,0,0,0,0,0,0,0
0,0,0,2,3,5,5,5,0,0
0,0,0,2,0,6,0,0,5,0
0,0,0,1,1,2,1,1,0,0
0,0,0,0,0,0,1,0,0,0
0,0,0,0,0,0,4,0,0,0
0,0,0,0,0,0,0,4,0,0
0,0,0,0,0,0,0,4,0,0
0,0,0,0,0,0,0,0,0,0
beam:6
diamondBeam:1
cubeBeam:6
cubeNova:6
vortex:8
none:7
