L16
0,0,0,0,0,0,0,0,0,0
0,0,0,0,0,0,0,0,0,0
0,0,0,0,0,0,0,0,0,0
0,0,0,0,5,5,0,0,0,0
0,0,0,5,0,5,0,0,0,0
0,0,5,5,5,5,5,5,0,0
0,0,0,5,0,5,0,0,0,0
0,0,0,0,5,5,0,0,0,0
0,0,0,0,0,0,0,0,0,0
0,0,0,0,0,0,0,0,0,0
sphere:6
none:7
none:7
none:7
none:7
none:7
