L17
0,0,0,0,0,0,0,0,0,0
0,0,0,0,1,0,0,0,0,0
0,0,1,1,0,1,1,0,0,0
0,0,1,0,5,5,0,0,0,0
0,2,3,5,0,3,2,0,0,0
0,2,0,5,3,3,0,0,0,0
0,4,5,2,1,2,0,0,0,0
1,1,0,1,4,2,0,0,0,0
0,0,0,0,0,0,0,0,0,0
0,0,0,0,0,0,0,0,0,0
cube:6
cube:6
vortex:6
cube:6
none:7
none:7
