L18
0,0,0,0,0,0,0,0,0,0
0,0,0,0,1,0,0,0,0,0
0,0,0,2,4,0,0,0,0,0
0,0,0,2,3,2,0,0,0,0
0,0,0,2,5,3,0,0,0,0
0,0,0,0,0,5,3,0,0,0
0,0,4,1,0,5,5,0,0,0
0,0,0,3,5,5,3,1,0,0
0,0,0,3,3,3,0,0,0,0
0,0,0,0,0,0,0,0,0,0
sphere:6
diamondNova:1
cube:6
vortex:8
cubeBeam:6
diamondBeam:0
