L19
0,0,0,0,0,0,0,0,0,0
0,0,0,3,3,3,3,0,0,0
0,1,5,5,0,3,0,0,0,0
0,0,0,5,3,0,0,3,0,0
0,6,2,2,6,2,5,1,0,0
0,0,0,0,0,3,0,1,0,0
0,0,1,1,1,5,1,1,1,0
0,0,0,5,0,0,0,5,0,0
0,0,1,1,0,0,0,1,0,0
0,0,0,0,0,0,0,0,0,0
cubeNova:6
cubeNova:6
vortexBeam:8
diamondNova:6
cubeBeam:6
none:7
