last1
0,0,0,0,0,0,0,0,0,0
0,0,0,0,0,0,0,0,0,0
0,2,0,0,0,0,1,0,0,0
0,0,6,5,5,0,2,3,2,0
0,4,0,0,0,0,0,0,3,0
0,0,6,4,6,5,2,3,2,0
0,0,0,6,0,0,3,0,0,0
0,0,0,6,0,0,0,2,0,0
0,2,6,0,0,0,0,3,1,0
0,0,0,0,0,0,0,0,0,0
sphere:8
beam:8
beam:8
cube:6
cube:6
diamond:6
modulate:true
shuffle:false
tutorialText:10 levels left