last2
0,0,0,0,0,0,0,0,0,0
0,1,0,4,0,0,2,2,0,0
0,1,4,0,0,2,0,2,0,0
0,0,2,0,4,3,0,0,0,0
0,2,0,4,0,3,0,0,3,0
0,2,0,4,0,3,0,3,3,0
0,2,2,0,3,0,3,0,2,0
0,0,0,1,0,3,3,0,2,0
0,0,0,1,0,0,0,0,0,0
0,0,0,0,0,0,0,0,0,0
sphere:8
cube:6
cube:6
diamond:6
vortex:6
none:7
