last3
0,0,0,0,0,0,0,0,0,0
0,0,1,0,0,0,2,0,0,0
0,0,5,5,5,4,0,0,0,0
0,0,5,1,0,2,5,0,6,0
0,5,0,5,5,0,6,6,0,0
0,5,0,5,0,3,5,0,6,0
0,5,0,5,5,5,0,0,0,0
0,0,5,0,0,0,3,0,0,0
0,0,5,5,5,0,0,0,0,0
0,0,0,0,0,0,0,0,0,0
sphere:8
cubeBeam:6
cubeBeam:6
nova:5
vortex:8
cubeBeam:6
