last4
0,0,0,2,2,0,0,0,0,0
0,0,0,2,1,0,0,0,0,0
0,0,3,3,0,6,6,0,0,0
0,0,5,5,3,6,0,6,0,0
0,5,3,3,0,6,6,1,1,0
0,5,6,2,0,0,0,5,6,1
0,5,6,2,6,0,5,6,1,0
0,5,2,2,5,5,5,0,1,0
0,5,5,5,5,0,1,1,0,0
0,0,0,0,0,0,0,0,0,0
sphere:5
diamondNova:1
cube:6
cube:6
vortexNova:6
none:6
