last5
0,0,0,0,0,0,0,0,0,0
0,0,0,0,0,0,0,0,5,0
0,2,4,4,4,5,0,5,4,0
0,2,5,0,0,3,5,5,3,0
2,5,3,0,3,3,3,3,0,0
0,2,5,0,0,3,0,3,3,0
0,2,5,3,3,1,0,3,0,0
0,0,4,0,0,0,1,1,0,0
0,2,0,0,0,0,0,0,0,0
0,0,0,0,0,0,0,0,0,0
sphere:6
cube:6
cube:6
none:6
diamond:0
vortex:6
