last7
0,0,0,0,0,0,0,0,0,0
0,0,0,0,0,0,0,0,0,0
0,0,0,0,0,0,5,0,0,0
0,0,0,0,2,2,5,0,0,0
0,3,0,3,0,1,0,3,0,0
0,6,2,3,6,4,4,5,1,0
0,0,0,0,5,0,0,0,0,0
0,0,0,0,5,0,0,0,0,0
0,0,0,0,0,0,0,0,0,0
0,0,0,0,0,0,0,0,0,0
pyramid:5
diamond:1
cubeBeam:6
cubeBeam:6
vortexBeam:8
vortexBeam:8
