last6
0,0,0,0,0,0,0,0,0,0
0,0,0,0,0,0,0,0,0,0
0,0,0,1,6,6,0,0,0,0
0,0,0,6,2,3,6,0,0,0
0,0,1,4,5,2,1,0,0,0
0,0,0,6,5,4,6,0,0,0
0,0,0,6,6,1,0,0,0,0
0,0,0,0,0,0,0,0,0,0
0,0,0,0,0,0,0,0,0,0
0,0,0,0,0,0,0,0,0,0
nova:4
vortexNova:6
diamondNova:2
cubeNova:6
vortexBeam:8
vortexBeam:8
modulate:true
shuffle:false
tutorialText:5 levels left