L9
0,0,0,0,0,0,0,0,0,0
0,0,0,0,0,0,0,0,0,0
0,0,0,0,0,0,0,0,0,0
0,0,0,5,2,5,2,0,0,0
0,0,3,0,0,0,1,0,0,0
0,0,0,3,0,0,6,0,0,0
0,0,0,3,0,1,0,0,0,0
0,0,0,0,3,6,0,0,0,0
0,0,0,0,0,0,0,0,0,0
0,0,0,0,0,0,0,0,0,0
beam:3
beam:3
diamondBeam:0
diamondBeam:1
beam:3
vortex:8
modulate:true
shuffle:false
tutorialText:4 levels left