last8
0,0,0,0,0,0,0,0,0,0
0,0,0,0,1,2,1,1,0,0
0,0,0,3,3,6,3,4,0,0
0,0,6,3,2,2,2,6,0,0
0,0,5,6,3,1,6,3,0,0
0,0,3,4,3,3,3,4,3,0
0,0,3,2,2,2,2,3,0,0
0,0,0,3,3,3,3,3,0,0
0,0,0,0,0,0,0,0,0,0
0,0,0,0,0,0,0,0,0,0
sphere:6
cube:6
cube:6
vortex:6
diamond:0
none:7
modulate:true
shuffle:false
tutorialText:3 levels left