???
0,0,0,0,0,0,0,0,0,0
0,0,0,0,0,0,0,0,0,0
0,0,0,0,0,0,0,0,0,0
0,0,0,0,1,1,1,0,0,0
0,0,0,1,3,3,1,0,0,0
0,0,0,0,1,3,1,0,0,0
0,0,0,0,1,1,0,0,0,0
0,0,0,0,0,0,0,0,0,0
0,0,0,0,0,0,0,0,0,0
0,0,0,0,0,0,0,0,0,0
nova:3
diamondNova:6
diamondNova:6
vortexNova:6
nova:1
none:0
modulate:true
shuffle:false
tutorialText:2 levels left