L8
0,0,0,0,0,0,0,0,0,0
0,0,0,0,0,0,0,0,0,0
0,0,2,0,0,1,0,0,0,0
0,0,0,6,0,5,0,0,0,0
0,5,0,2,1,0,5,0,0,0
0,0,2,4,3,3,1,0,0,0
0,5,0,1,2,0,5,0,0,0
0,0,0,5,0,6,0,0,0,0
0,0,0,0,0,0,0,0,0,0
0,0,0,0,0,0,0,0,0,0
nova:6
diamondNova:0
cubeBeam:6
cubeBeam:6
vortexBeam:8
diamondNova:6
