zzz
0,0,4,0,0,0,0,0,0,0
0,0,4,0,0,0,0,0,0,0
0,4,4,0,0,4,0,0,0,0
0,4,0,4,0,4,0,4,0,0
0,4,0,0,0,0,4,0,4,0
0,0,4,0,4,0,4,0,4,0
0,0,0,0,0,4,4,4,0,0
0,0,0,0,0,0,0,0,0,0
0,0,0,0,0,0,0,0,0,0
0,0,0,0,0,0,0,0,0,0
nova:8
nova:8
nova:8
nova:8
none:7
none:7
modulate:false
shuffle:false
tutorialText: