whiteDiamond2
0,0,0,0,0,0,0,0,0,0
0,0,0,3,0,0,1,0,0,0
0,0,0,3,0,1,0,0,0,0
0,0,0,0,3,1,0,0,0,0
0,0,0,0,2,0,0,0,0,0
0,0,0,0,0,2,0,0,0,0
0,0,0,0,0,2,0,0,0,0
0,0,0,0,0,0,2,0,0,0
0,0,0,0,0,0,0,0,0,0
0,0,0,0,0,0,0,0,0,0
diamondBeam:6
diamondBeam:6
beam:1
beam:3
beam:5
none:7
