crossing2
0,0,0,0,0,0,0,0,0,0
0,0,0,0,0,0,0,0,0,0
0,0,1,0,0,0,0,2,0,0
0,0,0,1,0,0,0,2,0,0
0,0,3,5,3,3,6,3,0,0
0,0,0,0,1,0,2,0,0,0
0,0,0,0,1,2,0,0,0,0
0,0,0,0,0,4,0,0,0,0
0,0,0,0,0,0,0,0,0,0
0,0,0,0,0,0,0,0,0,0
cubeBeam:6
cubeBeam:6
cubeBeam:6
none:7
none:7
none:7
