make a path
0,0,0,0,0,0,0,0,0,0
0,0,0,2,0,0,1,0,0,0
0,0,0,2,0,1,0,0,0,0
0,0,0,0,2,1,0,0,0,0
0,3,3,3,5,3,3,3,0,0
0,0,0,0,1,2,0,0,0,0
0,0,0,1,0,2,0,0,0,0
0,0,0,1,0,0,2,0,0,0
0,0,0,0,0,0,0,0,0,0
0,0,0,0,0,0,0,0,0,0
diamondBeam:1
cubeBeam:2
cubeBeam:0
cubeBeam:1
none:7
none:7
