careful
0,0,0,0,0,0,0,0,0,0
0,0,0,0,0,3,0,0,0,0
0,0,0,0,0,3,0,0,0,0
0,0,0,1,1,1,5,1,1,0
0,0,0,0,0,1,3,0,0,0
0,0,0,0,0,1,0,3,0,0
0,0,0,0,1,0,0,3,0,0
0,0,0,0,1,0,0,0,0,0
0,0,0,0,0,0,0,0,0,0
0,0,0,0,0,0,0,0,0,0
beam:6
beam:6
cubeBeam:2
none:7
none:7
none:7
