twisted
0,0,0,0,0,0,0,0,0,0
0,0,0,0,0,0,0,0,0,0
0,0,0,0,0,0,0,0,0,0
0,3,6,3,5,3,0,0,0,0
0,0,2,1,0,0,0,0,0,0
0,0,0,4,0,0,0,0,0,0
0,0,1,2,0,0,0,0,0,0
0,0,5,3,6,0,0,0,0,0
0,0,0,0,0,0,0,0,0,0
0,0,0,0,0,0,0,0,0,0
beam:6
cubeBeam:1
cubeBeam:2
cubeBeam:6
none:7
none:7
