triangle
0,0,0,0,0,0,0,0,0,0
0,0,0,0,0,0,0,0,0,0
0,0,3,3,3,3,3,0,0,0
0,0,1,0,0,0,0,2,0,0
0,0,1,0,0,0,2,0,0,0
0,0,0,1,0,0,2,0,0,0
0,0,0,1,0,2,0,0,0,0
0,0,0,0,1,2,0,0,0,0
0,0,0,0,0,0,0,0,0,0
0,0,0,0,0,0,0,0,0,0
beam:5
diamondBeam:2
beam:3
diamondBeam:1
beam:4
diamondBeam:0
