easy
0,0,0,0,0,0,0,0,0,0
0,0,0,3,0,0,1,0,0,0
0,0,0,3,0,1,0,0,0,0
0,0,0,0,3,1,0,0,0,0
0,3,3,3,3,3,3,3,3,0
0,0,0,0,0,0,0,0,0,0
0,0,0,0,0,0,0,0,0,0
0,0,0,0,0,0,0,0,0,0
0,0,0,0,0,0,0,0,0,0
0,0,0,0,0,0,0,0,0,0
cubeBeam:6
beam:4
diamondBeam:0
cubeBeam:0
none:7
none:7
