asfasdf
0,0,0,0,0,0,0,0,0,0
0,0,0,0,0,0,0,0,0,0
0,0,0,3,0,0,0,6,0,0
0,0,0,6,6,0,0,6,0,0
0,0,6,0,6,0,6,0,0,0
0,0,6,0,0,6,6,0,0,0
0,6,0,0,0,4,0,0,0,0
0,0,0,0,0,0,0,0,0,0
0,0,0,0,0,0,0,0,0,0
0,0,0,0,0,0,0,0,0,0
beam:6
beam:8
beam:6
none:7
none:7
none:7
