flips
0,0,0,0,0,0,0,0,0,0
0,0,0,0,0,0,0,0,0,0
0,0,0,0,3,0,0,0,0,0
0,0,0,0,3,4,0,0,0,0
0,0,0,3,1,4,0,0,0,0
0,0,0,3,1,1,4,0,0,0
0,0,3,1,1,1,4,0,0,0
0,0,6,0,0,0,0,0,0,0
0,0,0,0,0,0,0,0,0,0
0,0,0,0,0,0,0,0,0,0
nova:6
diamondBeam:2
diamondBeam:6
cubeBeam:0
vortexNova:8
none:7
