L15
0,0,0,0,0,0,0,0,0,0
0,0,0,0,0,0,0,0,0,0
0,1,0,0,0,0,1,0,0,0
0,0,4,6,2,6,4,0,0,0
0,3,0,0,0,0,3,0,0,0
0,0,4,4,5,4,4,0,0,0
0,0,0,4,4,0,0,0,0,0
0,0,1,5,0,5,1,0,0,0
0,0,0,1,1,0,0,0,0,0
0,0,0,0,0,0,0,0,0,0
cubeNova:6
cubeNova:6
diamond:6
cubeNova:6
vortexNova:6
diamond:6
