p2
0,0,0,0,0,0,0,0,0,0
0,0,0,0,0,0,0,0,0,0
0,0,0,0,6,2,0,0,0,0
0,0,0,0,3,0,4,0,0,0
0,0,0,0,5,1,0,0,0,0
0,0,0,4,2,0,0,0,0,0
0,0,1,0,6,0,0,0,0,0
0,0,0,5,3,0,0,0,0,0
0,0,0,0,0,0,0,0,0,0
0,0,0,0,0,0,0,0,0,0
pyramid:4
pyramid:5
none:0
none:0
none:0
none:0
