p3
0,0,0,0,0,0,0,0,0,0
0,0,0,4,4,4,2,2,0,0
0,0,0,6,3,3,0,2,0,0
0,0,0,6,0,0,3,0,4,0
0,0,6,0,1,0,5,0,4,0
0,0,2,0,1,0,5,0,4,0
0,0,2,0,1,5,0,2,0,0
0,0,0,2,0,0,0,2,0,0
0,0,0,4,4,4,2,0,0,0
0,0,0,0,0,0,0,0,0,0
pyramid:6
none:7
none:7
none:7
none:7
none:7
