p4
0,0,0,0,0,0,0,0,0,0
0,0,4,2,2,2,1,0,0,0
0,4,0,0,0,0,4,0,0,0
0,0,0,2,4,0,0,2,0,0
0,0,2,0,1,0,2,0,0,0
0,0,0,1,0,0,2,0,0,0
0,0,0,1,1,1,0,0,0,0
0,0,0,0,0,0,0,0,0,0
0,0,0,0,0,0,0,0,0,0
0,0,0,0,0,0,0,0,0,0
diamondBeam:6
diamondBeam:6
diamondBeam:6
pyramid:6
none:7
none:7
