p5
0,0,0,0,0,0,0,0,0,0
0,0,0,0,0,0,0,0,0,0
0,0,4,4,0,4,4,0,0,0
0,0,6,0,2,2,0,5,0,0
0,6,0,6,6,6,0,5,0,0
0,0,6,0,3,3,0,5,0,0
0,0,5,0,0,0,6,0,0,0
0,0,0,5,3,3,6,0,0,0
0,0,0,0,0,0,0,0,0,0
0,0,0,0,0,0,0,0,0,0
vortexNova:6
pyramid:6
vortexNova:6
none:7
none:7
none:7
