p6
0,0,0,0,0,0,0,0,0,0
0,0,3,3,5,5,3,0,0,0
0,0,0,0,0,0,3,0,0,0
0,0,0,6,4,4,6,6,0,0
0,0,6,0,0,0,0,0,0,0
0,0,3,3,5,5,3,0,0,0
0,0,0,0,0,0,3,0,0,0
0,0,3,3,2,2,3,3,0,0
0,0,0,0,0,0,0,0,0,0
0,0,0,0,0,0,0,0,0,0
pyramid:6
diamondBeam:0
vortexNova:8
diamondBeam:1
none:7
none:7
