p7
0,0,0,0,0,0,0,0,0,0
0,0,0,0,0,0,0,0,0,0
0,0,0,0,0,0,0,0,0,0
0,0,5,5,5,1,1,1,0,0
0,6,5,5,2,1,1,4,0,0
0,6,6,5,2,2,1,4,4,0
6,6,6,2,2,2,4,4,4,0
0,0,0,0,0,0,0,0,0,0
0,0,0,0,0,0,0,0,0,0
0,0,0,0,0,0,0,0,0,0
pyramid:6
none:7
none:7
none:7
none:7
none:7
