p8
0,0,0,0,0,0,0,0,0,0
0,0,2,0,0,0,0,0,2,0
0,0,2,5,5,5,5,2,0,0
0,0,0,4,2,2,2,4,0,0
0,0,1,0,0,0,0,1,0,0
0,0,0,4,0,3,0,4,0,0
0,0,0,4,3,3,4,0,0,0
0,0,0,0,6,2,6,0,0,0
0,0,0,3,0,0,3,0,0,0
0,0,0,0,0,0,0,0,0,0
cubeNova:6
cubeNova:6
pyramid:6
none:7
none:7
none:7
