p9
0,0,0,0,0,0,0,0,0,0
0,1,5,3,3,0,1,4,0,0
0,5,0,3,0,1,0,2,0,0
3,0,0,1,0,1,0,2,0,3
3,3,5,3,5,3,6,3,3,3
3,0,1,1,1,0,2,0,0,3
0,0,0,0,0,2,0,0,0,0
0,0,0,0,1,1,0,0,0,0
0,0,0,1,0,0,1,0,0,0
0,0,0,0,1,1,1,0,0,0
pyramid:0
cubeBeam:2
diamondBeam:6
vortexNova:6
cubeNova:6
none:7
