p91
0,0,0,0,0,0,4,0,0,0
0,0,5,1,0,0,0,4,4,4
0,3,0,4,4,4,0,4,0,0
0,0,6,2,4,0,4,0,4,0
0,0,0,0,4,0,4,4,0,0
0,4,4,4,4,4,2,0,0,0
0,0,4,0,1,0,6,0,0,0
0,0,4,0,0,5,3,0,0,0
0,0,0,0,0,0,0,0,0,0
0,0,0,0,0,0,0,0,0,0
nova:2
pyramid:6
pyramid:6
vortexNova:6
none:7
none:7
