spiral
0,1,1,1,1,1,0,0,0,0
0,1,0,0,0,0,1,0,0,0
0,0,1,1,1,0,1,0,0,0
0,0,1,0,0,1,0,1,0,0
0,1,0,1,0,1,0,1,0,0
0,0,1,0,1,1,0,1,0,0
0,0,1,0,0,0,1,0,0,0
0,0,0,1,1,1,1,0,0,0
0,0,0,0,0,0,0,0,0,0
0,0,0,0,0,0,0,0,0,0
sphere:0
none:7
none:7
none:7
none:7
none:7
