options
0,0,0,0,2,2,2,0,0,0
0,0,2,2,2,5,5,2,0,0
0,2,3,3,5,5,5,2,2,0
0,2,3,3,3,5,5,6,6,2
0,2,3,3,4,4,6,6,6,2
0,0,2,2,4,4,4,6,6,2
0,0,0,2,4,4,2,2,2,0
0,0,0,0,2,2,2,0,0,0
0,0,0,0,0,0,0,0,0,0
0,0,0,0,0,0,0,0,0,0
sphere:6
sphere:6
sphere:6
nova:6
nova:6
none:7
