Vortex test
0,0,0,0,0,0,0,0,0,0
0,0,0,0,0,0,0,0,0,0
0,1,1,1,1,1,1,0,0,0
0,1,5,5,2,2,1,0,0,0
0,1,5,2,2,2,1,0,0,0
0,1,5,5,2,2,1,0,0,0
0,1,5,5,1,1,1,0,0,0
0,0,0,0,0,0,0,0,0,0
0,0,0,0,0,0,0,0,0,0
0,0,0,0,0,0,0,0,0,0
vortexBeam:0
vortexBeam:1
vortexBeam:2
vortexBeam:6
vortexBeam:6
vortexBeam:6
