the wheel
0,0,0,1,0,0,0,6,0,0
0,0,0,0,1,2,2,6,0,0
0,0,0,2,1,2,6,2,0,0
0,0,0,2,2,1,6,2,2,0
0,4,4,4,4,5,4,4,4,4
0,0,0,2,2,6,1,2,2,0
0,0,0,2,6,2,1,2,0,0
0,0,0,0,6,2,2,1,0,0
0,0,0,6,0,0,0,1,0,0
0,0,0,0,0,0,0,0,0,0
vortex:6
vortex:6
vortex:6
vortex:8
vortex:8
vortex:8
