paths
3,3,3,6,6,6,6,4,0,0
3,0,0,3,0,0,6,0,4,0
3,0,0,3,0,6,0,0,4,0
0,3,0,0,6,6,0,0,0,4
0,3,3,3,0,5,5,5,5,0
0,2,0,0,2,5,0,0,0,5
2,0,0,2,0,5,0,0,5,0
0,2,0,2,0,0,5,0,5,0
0,2,2,1,1,1,5,5,0,0
0,0,0,0,0,0,0,0,0,0
none:7
none:7
none:7
none:7
none:7
none:7
