order
0,0,2,2,2,2,0,0,0,0
0,0,2,0,0,0,2,0,0,0
0,2,0,4,4,0,2,0,0,0
0,2,0,4,0,4,0,2,0,0
0,5,5,5,5,5,5,0,0,0
0,2,0,4,0,4,0,2,0,0
0,2,0,4,4,0,2,0,0,0
0,0,2,0,0,0,2,0,0,0
0,0,2,2,2,2,0,0,0,0
0,0,0,0,0,0,0,0,0,0
cubeBeam:0
nova:6
diamondNova:1
cubeBeam:2
none:7
none:7
