first nova
0,0,0,0,0,0,0,0,0,0
0,0,0,0,0,0,0,0,0,0
0,0,0,0,0,0,0,0,0,0
5,6,2,3,2,2,1,1,1,1
0,0,0,2,2,2,4,5,6,3
0,0,0,0,2,2,4,4,5,0
0,0,0,0,0,0,0,0,0,0
0,0,0,0,0,0,0,0,0,0
0,0,0,0,0,0,0,0,0,0
0,0,0,0,0,0,0,0,0,0
vortexNova:8
vortexNova:8
vortexNova:8
vortexNova:8
vortexNova:8
vortexNova:8
