airplane
0,0,0,0,0,0,0,0,0,0
0,0,0,0,0,0,0,0,0,0
0,2,0,1,0,2,0,0,0,0
0,3,2,1,5,6,3,0,0,0
0,3,4,3,4,3,0,0,0,0
0,0,1,2,2,1,0,0,0,0
0,1,3,2,3,1,0,0,0,0
0,0,0,6,6,0,0,0,0,0
1,1,4,5,4,1,1,0,0,0
0,0,0,0,0,0,0,0,0,0
nova:6
cube:6
cube:6
cubeBeam:6
none:7
none:7
