ddd
0,0,0,0,0,0,0,0,0,0
0,0,0,0,0,0,0,0,0,0
0,0,0,0,2,2,2,0,0,0
0,0,0,0,2,5,5,2,0,0
0,0,0,2,5,5,5,2,0,0
0,0,0,0,2,5,5,2,0,0
0,0,0,0,2,2,2,0,0,0
0,0,0,0,0,0,0,0,0,0
0,0,0,0,0,0,0,0,0,0
0,0,0,0,0,0,0,0,0,0
cube:2
diamond:0
nova:6
diamond:1
none:0
none:0
