vortex
0,0,0,0,0,0,0,0,0,0
0,0,0,0,0,0,0,0,0,0
0,0,0,0,0,0,0,0,0,0
0,0,0,0,1,1,0,0,0,0
0,6,6,1,1,1,6,6,0,0
0,0,6,6,1,1,6,6,0,0
0,0,6,6,6,6,6,0,0,0
0,0,0,6,6,6,6,0,0,0
0,0,0,0,0,0,0,0,0,0
0,0,0,0,0,0,0,0,0,0
nova:6
vortexNova:6
none:7
none:7
none:7
none:7
