vor
0,0,0,0,0,0,0,0,0,0
0,0,0,0,0,0,0,0,0,0
0,0,4,4,5,2,2,0,0,0
0,0,4,4,5,5,2,2,0,0
0,4,4,5,5,5,2,2,0,0
0,0,4,4,5,5,2,2,0,0
0,0,4,4,5,2,2,0,0,0
0,0,0,0,0,0,0,0,0,0
0,0,0,0,0,0,0,0,0,0
0,0,0,0,0,0,0,0,0,0
nova:6
cubeNova:0
vortexNova:6
none:7
none:7
none:7
