Cube Nova2
0,0,0,0,0,0,0,0,0,0
0,0,0,0,0,0,0,0,0,0
0,0,0,2,2,2,0,0,0,0
0,0,0,2,6,6,2,0,0,0
0,0,2,6,2,6,2,0,0,0
0,0,0,2,6,6,2,0,0,0
0,0,0,2,2,2,0,0,0,0
0,0,0,0,0,0,0,0,0,0
0,0,0,0,0,0,0,0,0,0
0,0,0,0,0,0,0,0,0,0
cubeNova:1
nova:2
none:7
none:7
none:7
none:7
