Diamond Nova2
0,0,0,0,0,0,0,0,0,0
0,0,0,0,0,0,0,0,0,0
0,0,0,0,0,3,3,0,0,0
0,0,0,6,0,3,0,3,0,0
0,0,6,6,0,3,0,6,6,0
0,0,0,3,0,3,0,6,6,0
0,0,0,3,3,0,0,0,0,0
0,0,0,0,0,0,0,0,0,0
0,0,0,0,0,0,0,0,0,0
0,0,0,0,0,0,0,0,0,0
diamondNova:1
nova:5
none:7
none:7
none:7
none:7
