Add or take?
0,0,0,0,0,0,0,0,0,0
0,0,0,2,0,0,2,0,0,0
0,0,2,2,2,2,2,0,0,0
0,0,2,2,4,4,2,2,0,0
0,0,2,4,4,4,2,0,0,0
0,0,2,2,4,4,2,2,0,0
0,0,2,2,2,2,2,0,0,0
0,0,0,2,0,0,2,0,0,0
0,0,0,0,0,0,0,0,0,0
0,0,0,0,0,0,0,0,0,0
nova:5
cubeNova:0
diamondNova:2
none:7
none:7
none:7
