Add or take2?
0,0,0,0,0,0,0,0,0,0
0,0,0,0,3,3,0,0,0,0
0,0,0,3,5,3,0,0,0,0
0,0,0,3,5,5,3,0,0,0
0,0,5,5,0,5,5,0,0,0
0,0,0,3,5,5,3,0,0,0
0,0,3,3,5,3,3,0,0,0
0,0,0,3,3,3,3,0,0,0
0,0,0,0,0,0,0,0,0,0
0,0,0,0,0,0,0,0,0,0
nova:5
cubeNova:0
diamondNova:1
none:7
none:7
none:7
