Take it all
0,0,0,0,0,0,0,0,0,0
0,0,0,0,0,0,0,0,0,0
0,0,0,0,0,0,0,0,0,0
0,2,2,0,4,4,0,1,1,0
2,2,2,4,4,4,1,1,1,0
0,2,2,0,4,4,0,1,1,0
0,0,0,0,0,0,0,0,0,0
0,0,0,0,0,0,0,0,0,0
0,0,0,0,0,0,0,0,0,0
0,0,0,0,0,0,0,0,0,0
cubeNova:0
cubeNova:1
none:7
none:7
none:7
none:7
