add it up
0,0,0,0,0,0,0,0,0,0
0,0,0,0,0,0,0,0,0,0
0,0,0,0,0,0,0,0,0,0
0,0,0,0,3,0,0,2,0,0
0,0,0,3,3,0,2,2,0,0
0,0,0,3,3,3,2,2,2,0
0,0,0,3,3,0,2,2,0,0
0,0,0,0,0,0,0,0,0,0
0,0,0,0,0,0,0,0,0,0
0,0,0,0,0,0,0,0,0,0
diamondNova:1
diamondNova:2
nova:6
none:7
none:7
none:7
