which first?
0,0,0,0,0,0,0,0,0,0
0,0,0,0,6,6,0,0,0,0
0,0,0,6,6,6,0,0,0,0
0,0,0,3,3,3,3,0,0,0
0,0,3,3,3,3,3,0,0,0
0,0,0,5,5,5,5,0,0,0
0,0,0,5,5,5,0,0,0,0
0,0,0,0,0,0,0,0,0,0
0,0,0,0,0,0,0,0,0,0
0,0,0,0,0,0,0,0,0,0
cubeNova:0
diamondNova:1
nova:6
none:7
none:7
none:7
