white cube nova2
0,0,0,0,0,0,0,0,0,0
0,0,0,0,0,0,0,0,0,0
0,0,0,0,3,0,0,0,0,0
0,0,0,0,6,6,0,0,0,0
0,0,3,6,6,6,3,0,0,0
0,0,0,0,6,6,0,0,0,0
0,0,0,0,3,0,0,0,0,0
0,0,0,0,0,0,0,0,0,0
0,0,0,0,0,0,0,0,0,0
0,0,0,0,0,0,0,0,0,0
nova:6
cubeNova:6
none:7
none:7
none:7
none:7
