white diamond nova2
0,0,0,0,0,0,0,0,0,0
0,0,0,0,0,0,0,0,0,0
0,0,0,0,0,0,0,0,0,0
0,0,0,0,2,2,0,0,0,0
0,0,0,2,2,2,0,0,0,0
0,0,0,1,2,2,1,0,0,0
0,0,0,1,1,1,0,0,0,0
0,0,0,0,1,1,0,0,0,0
0,0,0,0,1,0,0,0,0,0
0,0,0,0,0,0,0,0,0,0
diamondNova:6
nova:0
nova:3
none:7
none:7
none:7
