connections
0,0,0,0,0,0,0,0,0,0
0,0,0,0,0,0,0,0,0,0
0,0,0,0,0,0,0,0,0,0
0,0,1,1,0,0,0,5,5,0
0,1,3,1,1,1,5,3,5,0
0,0,1,1,0,0,0,5,5,0
0,0,0,0,0,0,0,0,0,0
0,0,0,0,0,0,0,0,0,0
0,0,0,0,0,0,0,0,0,0
0,0,0,0,0,0,0,0,0,0
diamondNova:2
cubeNova:2
nova:0
none:7
none:7
none:7
