mix it up
0,0,0,0,0,0,0,0,0,0
0,0,0,5,5,5,5,5,0,0
0,0,5,4,4,1,1,5,0,0
0,0,5,4,4,4,1,1,5,0
0,5,4,4,4,1,1,1,5,0
0,5,4,4,4,1,1,1,5,0
0,5,4,4,1,1,1,5,0,0
0,0,5,5,5,5,5,5,0,0
0,0,0,0,0,0,0,0,0,0
0,0,0,0,0,0,0,0,0,0
cubeNova:1
diamondNova:2
nova:6
none:7
none:7
none:7
