Shpere
0,0,0,0,0,0,0,0,0,0
0,0,0,0,1,1,0,0,0,0
0,0,0,1,0,1,0,0,0,0
0,0,0,1,0,0,1,0,0,0
0,0,0,1,0,1,0,0,0,0
0,0,0,0,1,1,0,0,0,0
0,0,0,0,0,0,0,0,0,0
0,0,0,0,0,0,0,0,0,0
0,0,0,0,0,0,0,0,0,0
0,0,0,0,0,0,0,0,0,0
sphere:0
none:7
none:7
none:7
none:7
none:7
modulate:true
shuffle:false
tutorialText:the <color=#ffffffff>sphere</color> can hop from hex to hex