Shpere2
0,0,0,0,0,0,0,0,0,0
0,0,0,0,0,0,0,0,0,0
0,0,0,0,0,0,0,0,0,0
0,0,4,0,0,4,4,0,0,0
0,0,4,0,4,0,4,0,0,0
0,0,4,0,4,0,0,4,0,0
0,0,4,4,0,0,4,0,0,0
0,0,0,0,0,0,0,0,0,0
0,0,0,0,0,0,0,0,0,0
0,0,0,0,0,0,0,0,0,0
sphere:3
none:7
none:7
none:7
none:7
none:7
