Shpere3
0,0,0,0,0,0,0,0,0,0
0,0,2,2,0,0,0,0,0,0
0,2,2,2,0,2,2,2,2,0
0,0,2,2,0,0,0,0,0,0
0,0,0,0,0,0,0,0,0,0
0,0,2,2,0,0,2,2,0,0
0,2,0,2,0,2,0,2,0,0
0,2,0,0,2,2,0,2,0,0
0,0,0,0,0,0,0,0,0,0
0,0,0,0,0,0,0,0,0,0
beam:1
nova:1
sphere:1
none:7
none:7
none:7
