white sphere and cube
0,0,0,0,0,0,0,0,0,0
0,0,0,0,1,1,3,3,0,0
0,0,0,1,0,1,0,3,0,0
0,0,0,1,0,1,0,5,0,0
0,0,0,1,0,0,5,0,0,0
0,0,0,0,5,5,5,0,0,0
0,0,0,0,0,0,0,0,0,0
0,0,0,0,0,0,0,0,0,0
0,0,0,0,0,0,0,0,0,0
0,0,0,0,0,0,0,0,0,0
sphere:6
cube:6
none:7
none:7
none:7
none:7
