white nova and cube
0,0,0,0,0,0,0,0,0,0
0,0,0,0,0,0,0,0,0,0
0,0,0,2,0,2,0,0,0,0
0,0,0,0,6,6,0,0,0,0
0,0,2,6,3,6,2,0,0,0
0,0,0,0,6,6,0,0,0,0
0,0,0,2,0,2,0,0,0,0
0,0,0,0,0,0,0,0,0,0
0,0,0,0,0,0,0,0,0,0
0,0,0,0,0,0,0,0,0,0
cubeNova:6
cube:6
none:7
none:7
none:7
none:7
