white diamond
0,0,0,0,0,0,0,0,0,0
0,0,0,0,0,0,0,0,0,0
0,0,3,3,3,3,3,3,3,0
0,0,3,6,3,2,2,3,6,3
0,0,3,3,3,3,3,3,3,0
0,0,0,0,0,0,0,0,0,0
0,0,0,0,0,0,0,0,0,0
0,0,0,0,0,0,0,0,0,0
0,0,0,0,0,0,0,0,0,0
0,0,0,0,0,0,0,0,0,0
nova:6
nova:6
diamond:6
none:7
none:7
none:7
