white diamond
0,0,0,0,0,0,0,0,0,0
0,0,0,0,0,0,0,0,0,0
0,0,0,0,0,0,0,0,0,0
0,0,0,0,0,0,0,0,0,0
0,3,3,0,0,0,5,5,0,0
0,3,1,3,3,3,5,3,5,0
0,3,3,0,0,0,5,5,0,0
0,0,0,0,0,0,0,0,0,0
0,0,0,0,0,0,0,0,0,0
0,0,0,0,0,0,0,0,0,0
diamond:6
cubeNova:6
cubeNova:6
none:7
none:7
none:7
