cell
0,0,0,0,0,0,0,0,0,0
0,0,3,0,3,0,0,0,0,0
3,3,3,3,0,3,0,0,0,0
0,3,1,1,3,3,3,3,0,0
3,1,2,1,4,4,3,0,0,0
3,1,2,1,4,1,2,3,0,0
3,1,4,4,1,2,3,3,0,0
3,3,1,1,1,3,3,0,0,0
0,3,3,3,3,0,3,0,0,0
0,3,0,3,0,3,0,0,0,0
sphere:6
sphere:6
diamond:6
nova:6
none:7
none:7
