asfasdf
0,0,0,0,4,0,0,0,0,0
0,0,0,0,4,4,0,0,0,0
0,0,0,2,2,2,0,0,0,0
0,0,0,2,2,2,2,0,0,0
0,0,2,0,2,0,2,0,0,0
0,0,1,0,0,0,0,1,0,0
0,0,1,0,0,0,1,0,0,0
0,0,0,1,1,1,1,0,0,0
0,0,0,0,0,0,0,0,0,0
0,0,0,0,0,0,0,0,0,0
cube:6
diamond:6
nova:6
none:7
none:7
none:7
