dfasdfas
0,0,0,0,0,0,0,0,0,0
0,0,0,0,0,0,0,0,0,0
0,0,0,0,0,0,0,0,0,0
0,3,3,1,1,3,3,1,1,3
1,0,5,0,5,0,5,0,5,0
0,1,1,3,3,1,1,3,3,1
0,0,0,0,0,0,0,0,0,0
0,0,0,0,0,0,0,0,0,0
0,0,0,0,0,0,0,0,0,0
0,0,0,0,0,0,0,0,0,0
cube:6
sphere:6
none:7
none:7
none:7
none:7
