make a path
0,0,0,0,0,1,1,0,0,0
0,0,0,0,0,1,0,0,0,0
0,0,0,0,0,1,0,0,0,0
0,0,0,0,2,1,0,0,0,0
0,0,2,2,1,2,2,0,0,0
0,0,0,0,1,2,0,0,0,0
0,0,0,1,0,0,0,0,0,0
0,0,1,0,1,0,0,0,0,0
0,0,1,1,0,0,0,0,0,0
0,0,0,0,0,0,0,0,0,0
cube:1
cube:0
diamond:6
none:7
none:7
none:7
