tttt
0,0,0,0,0,0,0,0,0,0
0,0,0,0,0,0,0,0,0,0
0,0,0,0,0,0,0,0,0,0
0,0,0,0,3,3,2,2,0,0
0,0,0,3,0,6,0,2,0,0
0,0,0,0,3,5,4,2,0,0
0,0,0,0,1,0,1,0,0,0
0,0,0,0,0,1,1,0,0,0
0,0,0,0,0,0,0,0,0,0
0,0,0,0,0,0,0,0,0,0
cube:6
cube:6
cube:6
none:7
none:7
none:7
