1
0,0,0,0,0,0,0,0,0,0
0,0,0,0,0,0,0,0,0,0
0,0,0,0,0,0,0,0,0,0
0,0,0,0,0,0,0,0,0,0
0,0,0,5,5,0,2,2,0,0
0,0,0,5,0,5,2,0,2,0
0,0,0,5,5,0,2,2,0,0
0,0,0,0,0,0,0,0,0,0
0,0,0,0,0,0,0,0,0,0
0,0,0,0,0,0,0,0,0,0
vortex:6
nova:1
none:7
none:7
none:7
none:7
