White Vortex2
0,0,0,0,0,0,0,0,0,0
0,0,0,0,0,0,0,0,0,0
0,0,0,0,0,0,0,0,0,0
0,0,0,2,0,5,0,2,0,0
0,0,2,2,5,5,2,2,0,0
0,0,2,2,2,5,2,2,2,0
0,0,2,2,5,5,2,2,0,0
0,0,0,2,0,5,0,2,0,0
0,0,0,0,0,0,0,0,0,0
0,0,0,0,0,0,0,0,0,0
vortexNova:6
nova:6
none:7
none:7
none:7
none:7
