Rainbow Vortex2
0,0,0,0,0,0,0,0,0,0
0,0,0,0,0,0,0,0,0,0
0,0,0,5,0,0,1,0,0,0
0,0,0,5,0,0,0,1,0,0
0,0,5,0,0,0,0,1,0,0
0,0,5,4,4,4,4,4,1,0
0,5,0,0,0,0,0,0,1,0
0,0,0,0,0,0,0,0,0,0
0,0,0,0,0,0,0,0,0,0
0,0,0,0,0,0,0,0,0,0
vortexNova:8
beam:0
beam:1
beam:2
none:7
none:7
