Vortex Prob
0,0,0,0,0,0,0,0,0,0
0,0,0,0,0,0,0,0,0,0
0,0,2,2,2,0,0,0,0,0
0,0,2,3,3,2,0,0,0,0
0,0,3,3,2,0,0,0,0,0
0,0,1,1,0,0,0,0,0,0
0,0,1,1,0,0,0,0,0,0
0,0,0,0,0,0,0,0,0,0
0,0,0,0,0,0,0,0,0,0
0,0,0,0,0,0,0,0,0,0
nova:0
cubeNova:1
vortexNova:6
none:7
none:7
none:7
