Vortex Prob2
0,0,0,0,0,0,0,0,0,0
0,0,0,0,0,0,0,0,0,0
0,0,0,2,2,2,0,0,0,0
0,0,0,2,6,6,2,0,0,0
0,0,2,6,6,6,2,0,0,0
0,0,0,4,4,4,4,0,0,0
0,0,0,4,4,4,0,0,0,0
0,0,0,0,0,0,0,0,0,0
0,0,0,0,0,0,0,0,0,0
0,0,0,0,0,0,0,0,0,0
nova:6
cubeNova:6
vortexNova:6
none:7
none:7
none:7
