Vortex Beam3
0,0,0,0,0,0,0,0,0,0
0,0,0,0,0,0,0,0,0,0
0,0,0,0,0,0,0,0,0,0
0,0,1,1,1,1,1,4,0,0
0,0,0,0,0,0,5,0,0,0
0,0,0,0,0,0,5,0,0,0
0,0,0,0,0,5,0,0,0,0
0,0,0,0,0,5,0,0,0,0
0,0,0,0,0,0,0,0,0,0
0,0,0,0,0,0,0,0,0,0
beam:6
cubeBeam:1
vortexBeam:6
none:7
none:7
none:7
