Rainbow Vortex beam2
0,0,0,0,0,0,0,0,0,0
0,0,0,0,5,0,3,0,0,0
0,0,0,0,5,2,0,0,0,0
0,0,0,0,0,1,0,0,0,0
0,0,0,0,6,5,0,0,0,0
0,0,0,0,4,0,5,0,0,0
0,0,0,5,0,0,5,0,0,0
0,0,0,1,0,0,0,5,0,0
0,0,0,0,0,0,0,0,0,0
0,0,0,0,0,0,0,0,0,0
beam:8
cubeBeam:1
vortexBeam:8
none:7
none:7
none:7
