lines
0,0,0,0,0,0,0,0,0,0
0,0,0,2,6,6,2,0,0,0
0,0,2,0,0,0,2,0,0,0
0,0,2,1,1,1,1,2,0,0
0,2,0,1,0,1,0,2,0,0
0,0,6,0,1,1,0,6,0,0
0,0,6,0,1,0,6,0,0,0
0,0,0,3,3,3,3,0,0,0
0,0,0,0,0,0,0,0,0,0
0,0,0,0,0,0,0,0,0,0
nova:6
vortex:6
diamondBeam:2
diamondBeam:1
diamondBeam:2
none:7
