far out
0,0,0,0,0,0,0,0,0,0
0,0,0,3,0,0,2,0,0,0
0,0,0,3,0,2,0,0,0,0
0,0,0,0,3,2,0,0,0,0
0,1,1,1,3,1,1,1,0,0
0,0,0,0,2,0,0,0,0,0
0,0,0,2,0,0,0,0,0,0
0,0,0,2,0,0,0,0,0,0
0,0,0,0,0,0,0,0,0,0
0,0,0,0,0,0,0,0,0,0
beam:6
vortexBeam:6
cubeBeam:1
beam:3
none:7
none:7
