flowers
5,5,0,3,3,0,0,0,0,0
5,1,5,3,1,3,3,3,0,0
5,5,0,3,3,0,6,6,0,0
0,0,0,0,0,0,6,2,6,0
0,0,1,1,0,0,6,6,0,0
0,0,1,2,1,1,1,0,0,0
0,0,1,1,0,0,0,0,0,0
0,0,0,4,4,4,4,4,0,0
0,0,0,0,0,4,4,4,0,0
0,0,0,0,0,0,4,4,0,0
nova:6
cubeNova:6
diamondNova:6
cubeNova:6
diamondNova:6
none:6
