takeAdd1
0,0,0,0,0,0,0,0,0,0
0,0,0,0,0,0,0,0,0,0
0,0,0,0,0,0,0,0,0,0
0,0,0,2,0,0,2,0,0,0
0,0,0,2,0,2,0,0,0,0
0,0,0,5,2,2,5,0,0,0
0,0,5,2,2,2,5,0,0,0
0,0,0,5,2,2,5,0,0,0
0,0,0,0,0,0,0,0,0,0
0,0,0,0,0,0,0,0,0,0
nova:4
cubeNova:0
cubeNova:1
cubeNova:2
diamondNova:0
diamondNova:2
