takeAdd2
0,0,0,0,0,0,0,0,0,0
0,0,0,4,0,0,4,0,0,0
0,0,4,0,0,0,4,0,0,0
0,0,3,3,0,0,3,3,0,0
0,3,0,3,0,3,0,3,0,0
0,0,0,4,3,3,4,0,0,0
0,0,4,0,0,0,4,0,0,0
0,0,0,0,0,0,0,0,0,0
0,0,0,0,0,0,0,0,0,0
0,0,0,0,0,0,0,0,0,0
nova:3
cubeNova:2
cubeNova:1
cubeNova:0
diamondNova:0
diamondNova:1
