tricky7
0,0,0,0,0,0,0,0,0,0
0,0,0,0,0,0,0,0,0,0
0,0,0,0,0,0,0,0,0,0
0,5,0,0,4,4,0,0,5,0
0,5,0,4,3,4,0,5,0,0
0,0,5,4,3,3,4,5,0,0
0,5,0,4,3,4,0,5,0,0
0,5,0,0,4,4,0,0,5,0
0,0,0,0,0,0,0,0,0,0
0,0,0,0,0,0,0,0,0,0
nova:4
diamondNova:2
cubeNova:6
cubeNova:2
diamondNova:1
none:7
