tricky8
0,0,0,0,0,0,0,0,0,0
0,0,5,5,0,0,2,2,0,0
0,5,0,5,3,2,0,2,0,0
0,0,5,0,3,3,0,2,0,0
0,4,0,4,3,4,0,4,0,0
0,0,4,4,3,3,4,4,0,0
0,0,0,4,4,4,0,0,0,0
0,0,0,6,3,3,6,0,0,0
0,0,0,6,6,6,0,0,0,0
0,0,0,0,0,0,0,0,0,0
nova:3
diamondNova:1
cubeNova:6
diamondNova:0
cubeNova:6
diamondNova:0
