tricky9
0,0,0,0,0,0,0,0,0,0
0,0,0,0,0,0,0,0,0,0
0,6,0,0,4,0,0,2,0,0
0,6,6,0,4,4,0,2,2,0
6,6,6,4,4,4,2,2,2,0
0,6,6,0,4,4,0,2,2,0
0,6,0,0,4,0,0,2,0,0
0,0,0,0,0,0,0,0,0,0
0,0,0,0,0,0,0,0,0,0
0,0,0,0,0,0,0,0,0,0
nova:3
diamondNova:1
cubeNova:6
nova:2
none:7
none:7
