tricky3
0,0,0,0,0,0,0,0,0,0
0,0,0,0,0,1,1,3,0,0
0,0,0,2,4,2,1,3,0,0
0,0,0,2,1,0,2,1,3,0
0,1,2,1,2,1,2,1,3,0
0,0,1,2,1,4,2,1,3,0
0,0,1,2,0,0,1,3,0,0
0,0,0,1,2,2,4,3,0,0
0,0,0,1,1,1,0,0,0,0
0,0,0,0,0,0,0,0,0,0
nova:5
diamondNova:2
cubeNova:6
diamondNova:6
none:7
none:7
