6
0,0,0,0,0,0,0,0,0,0
0,0,0,0,0,0,0,0,0,0
0,0,0,0,5,0,0,5,0,0
0,0,0,0,6,2,2,3,0,0
0,0,0,2,3,4,6,0,0,0
0,0,0,6,3,5,3,2,0,0
0,0,3,2,5,3,2,0,0,0
0,0,5,0,4,2,6,0,0,0
0,0,0,0,0,5,0,0,0,0
0,0,0,0,0,0,0,0,0,0
nova:4
diamondNova:0
cubeNova:6
cubeNova:6
none:7
none:7
