tricky5
0,0,5,0,5,0,5,0,0,0
0,0,2,1,4,4,1,2,0,0
0,1,4,2,2,2,4,1,0,0
0,0,1,2,1,1,2,1,0,0
5,4,4,1,0,1,4,4,5,0
0,0,1,2,1,1,2,1,0,0
0,1,4,2,2,2,4,1,0,0
0,0,2,1,4,4,1,2,0,0
0,0,5,0,5,0,5,0,0,0
0,0,0,0,0,0,0,0,0,0
nova:4
diamondNova:2
cubeNova:6
none:7
none:7
none:7
