2
0,0,0,0,0,0,0,0,0,0
0,0,0,0,2,0,2,0,0,0
0,0,0,0,4,4,0,0,0,0
0,0,0,0,0,6,0,0,0,0
0,0,0,6,6,6,6,0,0,0
0,0,0,6,0,1,0,6,0,0
0,0,4,3,1,1,3,4,0,0
0,0,2,0,5,0,5,0,2,0
0,0,0,0,0,0,0,0,0,0
0,0,0,0,0,0,0,0,0,0
none:7
cubeNova:6
diamondNova:6
cubeNova:6
cubeNova:6
none:7
