4
0,0,0,0,0,0,0,0,0,0
0,0,0,5,5,5,5,5,0,0
0,0,5,1,1,1,1,5,0,0
0,0,1,1,3,3,3,1,1,0
0,4,4,3,4,4,3,4,4,0
0,0,4,6,4,4,4,6,4,0
0,4,4,3,4,4,3,4,4,0
0,0,0,0,3,3,3,0,0,0
0,0,0,0,0,0,0,0,0,0
0,0,0,0,0,0,0,0,0,0
nova:3
diamondNova:1
cubeNova:6
cubeNova:6
cubeNova:6
nova:6
