tricky1
0,0,0,0,0,0,0,0,0,0
0,0,0,0,0,2,0,0,0,0
0,0,5,5,4,4,5,5,0,0
0,0,0,5,6,0,6,5,0,0
0,0,3,4,0,0,4,3,0,0
0,0,0,3,5,5,5,3,0,0
0,0,2,4,4,4,3,2,0,0
0,0,0,0,0,5,0,0,0,0
0,0,0,0,0,0,0,0,0,0
0,0,0,0,0,0,0,0,0,0
nova:6
cubeNova:6
cubeNova:0
diamondNova:6
diamondNova:6
none:7
