1
0,0,0,0,0,0,0,0,0,0
0,0,0,2,0,0,0,2,0,0
0,0,2,0,4,0,1,2,0,0
0,0,2,0,0,2,2,0,2,0
0,0,2,4,6,0,6,4,0,0
0,0,0,3,3,3,3,3,3,0
0,0,5,6,3,3,6,5,0,0
0,0,0,3,6,6,6,3,0,0
0,0,0,5,3,3,5,0,0,0
0,0,0,0,0,0,0,0,0,0
cubeNova:6
cubeNova:6
diamondNova:6
cubeNova:6
diamondNova:6
none:7
