tricky10
0,0,0,0,0,0,0,0,0,0
0,0,6,6,0,0,6,6,0,0
0,6,3,6,3,6,1,6,0,0
0,0,6,6,0,0,6,6,0,0
0,0,2,0,0,0,6,0,0,0
0,0,4,4,0,0,3,3,0,0
0,4,4,4,2,3,1,3,0,0
0,0,4,4,0,0,3,3,0,0
0,0,0,0,0,0,0,0,0,0
0,0,0,0,0,0,0,0,0,0
cubeNova:6
cubeNova:6
diamondNova:6
cubeNova:6
diamondNova:6
none:7
