tricky2
0,0,0,0,0,0,0,0,0,0
0,0,0,3,0,0,3,0,0,0
0,0,5,5,1,5,5,0,0,0
0,0,0,0,4,4,0,0,0,0
0,2,2,0,2,0,5,5,0,0
0,2,3,2,2,5,5,1,5,0
0,2,2,0,5,0,5,5,0,0
0,0,0,0,1,1,0,0,0,0
0,0,1,1,0,1,1,0,0,0
0,0,0,1,0,0,1,0,0,0
nova:6
cubeNova:6
cubeNova:6
diamondNova:6
cubeNova:6
none:7
