tricky4
0,0,0,0,0,0,0,0,0,0
0,0,6,6,0,1,0,0,0,0
0,0,6,0,6,1,0,0,0,0
2,4,3,3,3,0,0,0,0,0
2,0,4,0,3,0,0,0,0,0
0,0,4,2,0,3,6,3,0,0
0,0,0,0,3,0,3,0,0,0
0,2,4,6,3,0,0,0,0,0
0,4,0,0,3,0,0,0,0,0
0,0,0,0,2,2,0,0,0,0
nova:6
cubeNova:6
diamondNova:6
cubeNova:6
diamondNova:6
none:7
