L3
0,0,0,0,0,0,0,0,0,0
0,0,0,0,0,3,0,0,0,0
0,0,0,0,6,6,0,0,0,0
0,0,5,5,5,0,6,1,0,0
0,3,4,4,6,0,6,1,0,0
0,3,4,0,0,6,0,6,1,0
0,3,4,4,0,6,6,1,0,0
0,0,3,3,3,1,1,1,0,0
0,0,0,0,0,0,0,0,0,0
0,0,0,0,0,0,0,0,0,0
sphere:3
diamond:1
vortex:6
cube:6
cube:6
diamond:6
