L7
0,0,0,0,0,0,0,0,0,0
0,0,0,0,0,0,0,0,0,0
0,0,0,0,0,0,0,0,0,0
0,6,0,6,0,6,0,6,0,0
1,1,2,1,1,2,1,1,2,0
6,0,6,6,0,6,6,0,6,0
5,5,3,5,5,3,5,5,3,0
0,6,0,6,0,6,0,6,0,0
0,0,0,0,0,0,0,0,0,0
0,0,0,0,0,0,0,0,0,0
nova:5
vortex:6
cubeBeam:6
vortex:8
cubeBeam:6
diamondNova:6
