3 novas
0,0,0,0,0,0,0,0,0,0
0,0,0,0,0,5,5,0,0,0
0,0,0,0,5,5,5,0,0,0
0,0,0,6,6,5,5,0,0,0
0,0,6,6,6,4,4,0,0,0
0,0,0,6,6,4,4,4,0,0
0,0,0,0,0,4,4,0,0,0
0,0,0,0,0,0,0,0,0,0
0,0,0,0,0,0,0,0,0,0
0,0,0,0,0,0,0,0,0,0
nova:3
nova:4
nova:5
none:7
none:7
none:7
