careful now
0,0,0,0,0,0,0,0,0,0
0,0,0,3,3,3,2,2,2,0
0,0,3,3,3,2,2,2,1,0
0,0,0,3,3,5,2,2,1,1
0,0,6,6,5,5,4,4,1,0
0,0,0,6,6,5,4,4,4,0
0,0,0,6,6,4,4,4,0,0
0,0,0,0,0,0,0,0,0,0
0,0,0,0,0,0,0,0,0,0
0,0,0,0,0,0,0,0,0,0
nova:6
nova:6
nova:6
nova:1
nova:5
nova:2
