Rainbow and others
0,0,0,0,0,0,0,0,0,0
0,0,0,0,0,0,0,0,0,0
0,0,4,4,4,4,4,0,0,0
0,0,0,0,0,0,0,0,0,0
0,2,4,2,4,2,4,2,0,0
0,0,0,0,0,0,0,0,0,0
0,0,2,2,2,2,2,0,0,0
0,0,0,0,0,0,0,0,0,0
0,0,0,0,0,0,0,0,0,0
0,0,0,0,0,0,0,0,0,0
nova:6
nova:6
nova:8
none:7
none:7
none:7
