Rainbow and others 2
0,0,0,0,0,0,0,0,0,0
0,0,0,1,4,4,4,4,6,0
0,0,1,0,0,0,0,0,6,0
0,0,1,0,0,4,5,0,0,6
0,1,0,0,3,0,2,0,0,6
0,0,1,0,0,6,1,0,0,2
0,0,5,0,0,0,0,0,2,0
0,0,0,5,5,5,2,2,2,0
0,0,0,0,0,0,0,0,0,0
0,0,0,0,0,0,0,0,0,0
nova:0
nova:3
nova:4
nova:6
nova:6
nova:8
