tricky
0,0,0,0,0,0,0,0,0,0
0,0,0,0,0,0,0,0,0,0
0,0,0,4,4,4,4,0,0,0
0,0,0,4,2,2,2,4,0,0
0,0,4,2,3,4,2,4,0,0
0,0,0,4,2,3,2,4,0,0
0,0,0,4,2,2,4,0,0,0
0,0,0,0,4,4,4,0,0,0
0,0,0,0,0,0,0,0,0,0
0,0,0,0,0,0,0,0,0,0
nova:5
beam:2
vortexNova:8
cubeNova:2
vortexNova:8
none:7
