redty
0,0,0,0,0,0,0,0,0,0
0,2,0,0,4,4,0,0,2,0
0,2,2,4,1,4,2,2,0,0
0,5,6,6,4,4,6,6,5,0
5,6,5,6,4,6,5,6,5,0
5,6,5,5,6,6,5,5,6,5
5,5,0,5,5,5,0,5,5,0
0,0,0,2,0,0,2,0,0,0
0,0,0,0,0,0,0,0,0,0
0,0,0,0,0,0,0,0,0,0
sphere:6
nova:6
cube:6
vortexNova:6
none:7
none:7
