flowers2
0,0,0,0,0,0,0,0,0,0
0,0,0,0,0,0,0,0,0,0
0,0,6,6,0,4,4,0,0,0
0,0,6,2,6,4,1,4,0,0
0,0,6,6,0,4,4,3,0,0
0,0,6,0,0,0,0,0,3,0
0,3,3,0,0,5,5,3,0,0
0,3,1,3,3,5,3,5,0,0
0,3,3,0,0,5,5,0,0,0
0,0,0,0,0,0,0,0,0,0
cubeNova:6
cubeNova:6
diamondNova:6
cubeNova:6
none:7
none:7
