helix
0,0,0,0,0,0,0,0,0,0
0,0,0,0,0,0,0,0,0,0
0,0,0,0,0,0,0,0,0,0
0,1,1,0,6,6,0,5,5,0
1,0,1,6,0,6,5,0,5,0
0,1,1,0,6,6,0,5,5,0
0,0,0,0,0,0,0,0,0,0
0,0,0,0,0,0,0,0,0,0
0,0,0,0,0,0,0,0,0,0
0,0,0,0,0,0,0,0,0,0
vortexNova:6
cubeNova:1
diamondNova:6
diamondNova:2
nova:6
none:7
