asfasdf
0,0,0,0,0,0,0,0,0,0
0,0,0,0,0,0,0,0,0,0
0,0,0,0,2,2,2,0,0,0
0,0,0,0,2,4,4,2,0,0
0,0,0,2,4,2,4,2,0,0
0,0,0,0,2,4,4,2,0,0
0,0,0,0,2,2,2,0,0,0
0,0,0,0,0,0,0,0,0,0
0,0,0,0,0,0,0,0,0,0
0,0,0,0,0,0,0,0,0,0
vortexNova:8
diamondNova:2
diamondNova:0
diamondNova:2
nova:6
none:7
