mandala
0,0,0,0,0,0,0,0,0,0
0,0,2,4,4,4,4,2,0,0
0,2,1,3,1,3,1,2,0,0
0,2,1,1,5,5,1,1,2,0
2,0,6,6,5,6,6,0,2,0
0,2,1,1,5,5,1,1,2,0
0,2,1,3,1,3,1,2,0,0
0,0,2,4,4,4,4,2,0,0
0,0,0,0,0,0,0,0,0,0
0,0,0,0,0,0,0,0,0,0
nova:5
diamond:1
cubeNova:6
cube:6
none:7
none:7
