gtyh
0,0,0,4,0,4,0,0,0,0
0,0,0,4,4,4,4,0,0,0
0,4,4,3,2,3,4,4,0,0
0,0,4,2,5,5,2,4,0,0
0,4,3,5,2,5,3,4,0,0
0,4,4,2,5,5,2,4,4,0
0,0,4,3,2,3,4,0,0,0
0,0,4,4,4,4,4,4,0,0
0,0,0,0,4,0,0,0,0,0
0,0,0,0,0,0,0,0,0,0
nova:6
diamondNova:2
cubeNova:6
vortexNova:6
sphere:6
none:7
