2
0,0,0,0,0,0,0,0,0,0
0,0,0,0,0,0,0,0,0,0
0,0,0,5,2,3,0,0,0,0
0,0,0,2,5,2,0,0,0,0
0,3,3,2,5,2,3,3,0,0
0,0,0,0,2,1,2,0,0,0
0,0,0,3,2,5,2,0,0,0
0,0,0,0,0,2,2,0,0,0
0,0,0,0,0,0,0,0,0,0
0,0,0,0,0,0,0,0,0,0
nova:2
cubeBeam:0
cube:6
diamond:6
none:7
none:7
