messy
0,0,0,0,0,0,0,0,0,0
0,0,0,0,0,5,1,0,0,0
0,0,0,6,1,3,4,0,0,0
0,0,5,1,3,6,1,2,0,0
0,1,3,6,3,2,2,0,0,0
0,0,4,1,2,0,0,0,0,0
0,0,2,2,0,0,0,0,0,0
0,0,0,0,0,0,0,0,0,0
0,0,0,0,0,0,0,0,0,0
0,0,0,0,0,0,0,0,0,0
sphere:6
cube:6
vortexBeam:8
cube:6
none:7
none:7
