moarflowers
0,0,3,3,0,5,5,0,0,0
0,0,3,0,3,5,3,5,0,0
0,0,3,3,0,5,5,0,0,0
0,3,3,0,3,3,0,5,5,0
3,2,3,3,0,3,5,0,5,0
0,3,3,0,3,3,6,5,5,0
0,0,1,1,0,6,6,0,0,0
0,0,1,0,1,6,2,6,0,0
0,0,1,1,0,6,6,0,0,0
0,0,0,0,0,0,0,0,0,0
nova:6
cube:6
vortexNova:6
cube:6
none:6
none:7
