poluck
0,3,0,0,0,3,3,0,0,0
0,3,0,2,2,3,2,3,3,0
3,0,2,0,6,2,4,4,3,0
0,6,6,3,6,2,4,0,4,3
6,4,3,4,1,0,4,0,4,0
6,4,3,4,0,1,0,4,0,4
6,4,4,2,2,1,4,0,4,0
0,2,2,2,0,2,2,0,4,0
0,0,4,0,4,4,2,4,0,0
0,0,0,4,4,0,4,1,0,0
sphere:6
sphere:6
diamondBeam:6
cubeNova:6
none:7
none:7
