ggfs
0,0,0,0,0,0,0,0,0,0
0,0,0,0,0,0,0,0,0,0
0,6,6,6,6,6,6,0,0,0
0,6,5,5,5,5,5,6,0,0
0,3,0,0,0,0,3,0,0,0
0,0,3,2,2,2,3,0,0,0
0,0,3,2,2,3,0,0,0,0
0,0,0,6,3,6,0,0,0,0
0,0,0,2,2,0,0,0,0,0
0,0,0,0,0,0,0,0,0,0
sphere:6
none:7
diamond:6
cube:6
vortexNova:6
none:7
