heloo
0,0,0,0,0,0,0,0,0,0
0,0,0,0,5,5,0,0,0,0
0,0,0,5,0,5,0,0,0,0
0,0,0,5,0,0,5,0,0,0
0,0,5,0,0,0,5,0,0,0
0,0,0,5,0,0,5,0,0,0
0,0,0,5,5,5,0,0,0,0
0,0,0,0,0,0,0,0,0,0
0,0,0,0,0,0,0,0,0,0
0,0,0,0,0,0,0,0,0,0
vortexNova:6
diamondNova:0
vortexNova:6
diamondNova:1
none:0
nova:5
