helix
0,0,0,0,0,0,0,0,0,0
0,0,5,5,5,5,5,0,0,0
0,5,6,6,6,6,5,0,0,0
0,5,6,2,2,2,6,5,0,0
5,6,2,6,6,2,6,5,0,0
0,5,2,6,2,2,6,5,0,0
0,5,2,6,6,6,5,0,0,0
0,0,5,5,5,5,5,0,0,0
0,0,0,0,0,0,0,0,0,0
0,0,0,0,0,0,0,0,0,0
vortexNova:6
diamondNova:6
diamondNova:0
nova:3
vortexNova:6
none:7
