ways
0,0,0,0,0,0,0,0,0,0
0,2,2,2,6,4,2,2,2,0
2,0,0,0,5,0,0,0,2,0
2,0,2,2,4,6,2,2,0,2
2,0,0,1,0,3,0,0,2,0
0,2,2,4,2,2,6,2,2,0
0,0,0,0,0,0,0,0,0,0
0,0,0,0,0,0,0,0,0,0
0,0,0,0,0,0,0,0,0,0
0,0,0,0,0,0,0,0,0,0
beam:3
cubeBeam:0
cubeBeam:1
vortexBeam:8
cube:6
none:7
