lines
0,0,0,0,0,0,0,0,0,0
0,0,0,0,4,4,4,4,0,0
0,0,0,2,2,2,2,2,0,0
0,0,0,4,4,0,0,4,4,0
0,0,1,1,3,3,3,1,1,0
0,0,0,4,4,0,0,4,4,0
0,0,0,2,2,2,2,2,0,0
0,0,0,0,4,4,4,4,0,0
0,0,0,0,0,0,0,0,0,0
0,0,0,0,0,0,0,0,0,0
nova:6
beam:5
diamondBeam:1
diamondBeam:0
diamondBeam:0
none:0
