3
0,0,0,0,0,0,0,0,0,0
0,0,0,0,0,0,0,0,0,0
0,0,0,0,3,3,0,0,0,0
0,0,0,0,0,4,0,0,0,0
0,5,0,0,4,4,0,0,4,0
0,0,5,0,4,0,4,3,4,0
0,0,5,4,6,6,4,4,0,0
0,0,0,0,4,0,4,0,0,0
0,0,0,0,4,4,0,0,0,0
0,0,0,0,0,0,0,0,0,0
nova:5
diamondNova:2
diamondNova:6
cubeNova:6
cubeNova:2
diamondNova:0
