5
0,0,0,0,0,0,0,0,0,0
0,0,0,0,0,0,0,0,0,0
0,0,0,2,2,2,0,0,0,0
0,0,0,2,0,0,2,0,0,0
0,5,5,1,1,1,5,1,0,0
0,5,2,4,4,4,4,2,1,0
0,5,5,1,1,1,5,1,0,0
0,0,0,2,0,0,2,0,0,0
0,0,0,2,2,2,0,0,0,0
0,0,0,0,0,0,0,0,0,0
nova:4
diamondNova:2
cubeNova:6
diamondNova:6
diamondNova:2
cubeNova:1
