liness
0,0,0,0,0,0,0,0,0,0
0,0,0,0,0,0,0,0,0,0
0,0,0,1,0,1,1,1,0,1
0,0,3,5,3,5,3,5,3,5
0,0,1,0,1,0,1,0,1,0
0,0,4,4,4,2,4,4,4,2
0,0,0,0,0,0,0,0,0,0
0,0,0,0,0,0,0,0,0,0
0,0,0,0,0,0,0,0,0,0
0,0,0,0,0,0,0,0,0,0
sphere:6
cubeBeam:6
cubeBeam:6
none:7
none:7
none:7
