ddd
0,0,0,0,0,0,0,0,0,0
0,0,0,0,0,0,0,0,0,0
0,0,0,0,6,0,0,0,0,0
0,0,0,0,6,6,0,0,0,0
0,0,0,1,1,1,0,0,0,0
0,0,0,4,1,1,4,0,0,0
0,0,4,1,1,1,4,0,0,0
0,0,0,4,1,1,4,0,0,0
0,0,0,0,0,0,0,0,0,0
0,0,0,0,0,0,0,0,0,0
nova:6
diamondNova:2
cubeNova:6
diamondBeam:1
none:7
none:7
