thechurch
0,0,0,0,0,0,0,0,0,0
0,0,0,0,0,0,0,0,0,0
0,0,0,0,4,0,0,0,0,0
0,0,0,0,4,4,0,0,0,0
0,0,0,4,1,4,1,0,0,0
0,0,5,6,6,6,6,5,0,0
0,0,1,4,0,4,1,0,0,0
0,0,0,0,4,4,0,0,0,0
0,0,0,0,4,0,0,0,0,0
0,0,0,0,0,0,0,0,0,0
cubeNova:6
cubeBeam:6
cube:6
none:7
none:7
none:7
