thedog
0,0,0,0,0,0,0,0,0,0
0,0,0,2,2,2,0,0,0,0
0,4,4,3,3,4,4,0,0,0
0,4,3,3,3,3,3,4,0,0
0,4,5,4,4,5,4,0,0,0
0,2,3,6,1,6,3,2,0,0
0,2,6,3,3,6,2,0,0,0
0,0,2,0,3,0,2,0,0,0
0,0,0,0,0,0,0,0,0,0
0,0,0,0,0,0,0,0,0,0
nova:6
cube:6
cube:6
none:7
none:7
none:7
