twisted
0,0,0,0,0,0,0,0,0,0
0,0,0,0,0,0,0,0,0,0
0,0,0,0,0,3,0,0,0,0
0,1,3,2,1,5,3,2,1,3
3,5,6,4,6,1,6,4,5,0
0,2,4,5,3,2,4,5,6,4
0,2,1,3,0,2,1,3,2,1
0,0,0,0,0,0,0,0,0,0
0,0,0,0,0,0,0,0,0,0
0,0,0,0,0,0,0,0,0,0
sphere:6
cube:6
cube:6
none:7
none:7
none:7
