twisted5
0,0,0,0,0,0,0,0,0,0
0,0,0,0,0,2,2,0,0,0
0,0,0,1,4,1,2,0,0,0
0,0,3,5,6,3,1,2,0,0
0,3,1,2,4,3,1,2,0,0
0,3,1,2,1,2,1,2,0,0
3,0,4,0,1,4,2,0,0,0
0,3,2,1,0,0,0,0,0,0
0,3,2,5,1,1,0,0,0,0
0,0,3,6,2,2,0,0,0,0
cube:6
cube:6
cube:6
none:7
none:7
none:7
